1111111111111111
1111111111111111
1111111111111111
1111111111111111
1111111111111111
2222222222222222
2222333333332222
3333333333333333
3333333333333333